🟪 🟪 🟪 🟪 🟪 🟪 🟪 🟪 🟪 🟪
🟪 ⚫ ⚫ ⚫ ⚫ ⚫ ⚫ ⚫ ⚫ 🟪
🟪 ⚫ ⚫ 💀 ⚫ ⚫ ⚫ ⚫ ⚫ 🟪
🟪 ⚫ 🧬 ⚫ ⚫ ⚫ ⚫ ⚫ ⚫ 🟪
🟪 ⚫ ⚫ ⚫ ⚫ ⚫ ⚫ 🧪 ⚫ 🟪
🟪 ⚫ ⚫ 💀 ⚫ ⚫ ⚫ ⚫ ⚫ 🟪
🟪 ⚫ ⚫ ⚫ 🥷 ⚫ ⚫ ⚫ ⚫ 🟪
🟪 ⚫ ⚫ ⚫ ⚫ ⚫ ⚫ ⚫ ⚫ 🟪
🟪 ⚫ 🪙 ⚫ ⚫ ⚫ ⚫ ⚫ ⚫ 🟪
🟪 🟪 🟪 🟪 🟪 🟪 🟪 🟪 🟪 🟪